##############
#%..........%#
#%..........%#
#%###%......%#
#%...%......%#
#%...%####%.%#
#%........%.%#
#%........%.%#
#%........%.%#
##############